1111111111111111111111111111111111
1X0000000X00000C00000C00E010010001
1010010100100000101001000010010101
1010010010101010001001000000001111
1P0001110C00C0000000000000100100C1
100000000111100110000X000111000011
100000000011001CC00000011111000001
1111111111111111111111111111111111