1111111111111111111111111111111111
10X000000000X00C00000C00E010010001
1010010100100000101001000010010101
1010010010101010001001000X00001111
1P0001110C00C0000000000000100100C1
10000X0001111001100X000001110X0011
100000000011001CC00000011111000001
1111111111111111111111111111111111