1111111111
1E00000001
1111111101
1000000001
1011111111
1000P00001
1111111101
1000000001
1011111111
10000000C1
1111111111