1111111111
1E00000001
1000000001
1000000001
1000000001
1000P00001
1000000001
1000000001
10000000C1
1111111111