111111111111
1E0000000001
10010X000001
100X10010001
100111111001
1000P0011001
100100000001
1000X1011101
1000000000C1
111111111111