11111111111111111111111111111111111
1P100000X000000X000000000X000000001
10101101111111111110111111011111101
100X001C00000X0000C10000X0000X001E1
11111101111101111111011111111111111
100000000000000X0000000000000X00001
10111111111111111110111111011111111
1000000000C0X100C000X000X00000000C1
11111111111111111111111111111111111