11111111111111111111111111
1X00P000000000000000000111
11111111111111111111110111
1E000000000000C00X00000001
11111111111111111111111111